0,0,1,1,1,0,0,0,1,1,0,0,0
0,0,1,0,0,1,1,0,4,4,4,0,0
0,1,0,0,0,1,1,1,1,0,4,4,0
0,1,0,0,1,1,1,1,1,0,4,4,1
0,0,1,1,1,3,2,2,1,0,4,0,0
0,0,0,4,4,3,2,0,1,2,4,1,1
0,0,4,4,2,3,1,1,1,2,4,1,5
0,0,4,4,2,3,2,0,1,0,4,1,1
0,0,0,4,4,3,2,2,1,0,4,4,0
0,0,1,1,1,3,1,1,1,0,4,4,0
0,1,0,0,0,1,1,1,1,0,4,4,1
0,1,0,0,0,1,1,0,4,4,4,4,0
0,0,1,1,1,0,0,0,1,1,0,0,0
