0,0,0,0,0,0,0,0,0,0,0,0,2
0,0,0,0,2,0,2,2,0,0,2,0,0
0,2,2,2,0,0,0,0,0,2,0,2,0
0,2,0,0,0,4,2,0,0,0,0,2,0
0,2,0,0,4,2,2,2,0,0,0,0,0
0,2,0,4,2,2,0,0,0,0,0,1,1
0,0,4,2,2,2,0,2,2,2,4,1,5
2,0,0,0,0,0,0,2,2,4,0,1,1
2,0,2,0,0,2,2,2,4,0,0,0,0
0,0,2,0,0,0,2,0,0,0,2,2,0
0,2,2,2,0,0,0,0,0,2,0,0,0
0,0,0,0,2,0,0,2,2,2,0,2,0
0,0,0,0,0,0,0,0,0,0,0,2,0
