0,1,0,0,0,0,2,0,0,1,1,0,0
0,0,0,2,0,0,1,0,0,0,0,1,1
0,0,2,2,2,0,0,0,0,0,0,0,1
1,0,4,2,4,4,2,4,0,0,2,4,0
0,0,0,0,0,2,2,2,0,2,2,2,0
0,0,2,0,0,4,2,4,0,0,2,4,1
0,2,2,2,0,0,0,0,0,0,0,1,5
0,4,2,4,0,4,2,4,0,0,2,4,1
0,0,0,0,0,2,2,2,0,2,2,2,0
0,2,0,0,0,4,2,4,0,0,2,4,0
2,2,2,0,0,0,0,0,0,0,0,0,1
4,2,4,0,0,0,1,0,0,0,0,1,1
0,1,0,0,0,0,2,0,0,1,1,0,0
